........................
......##................
..#######...............
.##.....##......##......
.#####..#......####.....
..########....######....
...#####.........##.....
...######...............
...###..................
........................